NO ./textures/north.xpm
SO ./textures/south.xpm
WE ./textures/west.xpm
EA ./textures/east.xpm

F 55, 55,55
C 55,55,255

        111111111111111111111111111111111111111111111
        101100000111000000000000000000000000000000001
        100100000000000000000000000000000000000000001
11111111101100000111000000000000000000000000000000001
10000000001100000111011111011000000000000000000000001
11110111111111011100000010001000000000000000000000001
11110111111111011101010010001000000000000000000000001
11000000110101011100000010001000000000000000000000001
10000000000000001100000010001111111111111111111111111
10000000000000000001010000001
110000011101010111110111100111
11110111 1110101 1011110000W1
11111111 1111111 111111111111