NO ./textures/north.xpm
SO ./textures/south.xpm
WE ./textures/west.xpm
EA ./textures/east.xpm

F 0,255,0
C 0,0,235

        1111111111111111111111111
        1000010000110000000000001
        1011000001110000000000001
        10010000000N0000000000001
111111111011000001110000000000001
100000000011000001110111110111111
11110111111111011100000010001
11110111111111011101010010001
11000000110101011100000010001
10000000000000001100000010001
10000000000000000001010000001
110000011101010111110111100111
11110111 1110101 101111000001
11111111 1111111 111111111111