NO textures/blue_stone.xpm
SO textures/color_stone.xpm
WE textures/grey_stone.xpm
EA textures/eagle.xpm
F 150,75,0
C 150,0,0
        1111111111111111111111111
        1000000000110000000000001
        1011000001110000000000001
        1001000000000000000000001
111111111011000001110000000000001
10000N00001100000111011111111111111111
11110111111111011100000010001
11110111111111011101010010001
11000000110101011100000010101
10000000000000001100000010101
10000000000000001101010010101
1100000111010101111101111000111
11110111111101011101111010001
11111111111111111111111111111
11111
11
