NO         textures/cat/cat_0.xpm       
   SO textures/color_stone.xpm

WE textures/grey_stone.xpm

F 150,         3      ,0
EA textures/eagle.xpm 

C 0,0,0
F 150,         3      ,0
        1111111111111111111111111
        1000000000110000000000001
        1011000001110000111000001
        10010000000000001 1000001
111111111011000001110000111000001
100000000011000001110111111111111
111101111111110111000000100N1
11110111111111011101010010011
11000000110101011100000010111
100000000000000011000000101011
10000000000000011010100101001
110000011101010111110111101011
11110111111101011101111010001
11111111111111111111111111111
